14,14,14,14,14,14,14,14,14,14,14,14,14,14,14,14
14,14,14,14,14,14,14,14,14,14,14,14,14,14,14,14
14,14,14,14,14,14,14,14,14,14,14,14,14,14,14,14
10,14,14,14,14,14,14,14,14,14,14,14,14,14,14,14
11,11,11,11,11,11,11,11,11,11,11,11,11,11,11,11
